3 6 6 5 0 0 3 6 6 6 6 6 6 5 0 0 7
7 6 6 7 0 0 2 6 6 6 6 6 5 7 0 0 7
2 6 6 4 0 0 7 0 0 0 0 0 7 7 0 0 7
7 0 0 0 0 0 7 0 0 0 0 0 7 7 0 0 7
7 0 0 0 0 0 7 0 0 7 0 0 7 7 0 0 7
7 0 0 3 6 6 4 0 0 7 0 0 2 4 0 0 7
7 0 0 7 0 0 0 0 0 7 0 0 0 0 0 0 7
7 0 0 7 0 0 0 0 0 7 0 0 0 0 0 0 7
7 0 0 7 0 0 6 6 6 1 6 6 6 6 6 6 6
7 0 0 7 0 0 0 0 0 7 0 0 0 0 0 0 7
7 0 0 7 0 0 0 0 0 7 0 0 0 0 0 0 7
7 0 0 7 0 0 7 0 0 7 0 0 3 5 0 0 7
7 0 0 7 0 0 7 0 0 7 0 0 7 7 0 0 7
7 0 0 7 0 0 7 0 0 0 0 0 7 7 0 0 7
7 0 0 0 0 0 7 0 0 0 0 0 7 7 0 0 7
7 0 0 0 0 0 3 6 6 6 6 6 4 7 0 0 7
2 6 6 6 6 6 2 6 6 6 6 6 6 4 0 0 7